NO ./path_to_no.xpm
SO ./path_to_so.xpm
WE ./path_to_we.xpm
EA ./path_to_ea.xpm

F 0,0,0
C 0,0,0

11111111111111111111
1010000000000000000N1
1001100000000000000N1
11010101111111111111
10111011
11111111
