NO ./path_to_no.xpm
SO ./path_to_so.xpm
WE ./path_to_we.xpm
EA ./path_to_ea.xpm

F 0,0,0
C 0,0,0

111111111111111111111
100000000000000000001
1001100000000000000N1
110101011111111111111
10111011001
11111111111
