NO ./path_to_no.xpm
SO ./path_to_so.xpm
WE ./path_to_we.xpm
EA ./path_to_ea.xpm

F 0,0,0
C 0,0,0

111111111111111111111
101000000000000000001
100110000000000000001
110101000000000000001
101110000000000000001
100010000000000000001
100010000000N00000001
100010000000000000001
100000000000000000001
100000000000000000001
100000011110000000001
111111111111111111111
