NO ./path_to_no.xpm
SO ./path_to_so.xpm
WE ./path_to_we.xpm
EA ./path_to_ea.xpm

F 0,0,0
C 0,0,0

111111111111111111111
101000000000000000001
100110000000000000001
1101010000000000N0001
101110001010000000001
100010011111100000001
10001001   1100000001
10001001   1000000010
100000011111000000001
100000000000000000001
100000011110000000001
111111111111111111111
