NO ./img/enzo2.xpm
SO ./img/enzo.xpm
WE ./img/WE.xpm
EA ./img/EA.xpm

F 200,200,0
C 0,100,100

111111111111111111111
100000000000000000001
100000000000000000001
100000000001000000001
100000000000000000001
101000000000000000001
100110000000000000001
110101000000000000001
101110001010000000001
100010011111100000001
10001001   1100000001
10001001   1000000011
100000011111000000001
10000000000000W000001
100000011110000000001
111111111111111111111
