NO ./img/NO.xpm
SO ./img/SO.xpm
WE ./img/WE.xpm
EA ./img/EA.xpm

F 0,255,255
C 0,0,255

1111
1001
1001
10E1
1111
