NO ./path_to_no.xpm
SO ./path_to_so.xpm
WE ./path_to_we.xpm
EA ./path_to_ea.xpm

F 0,0,0
C 0,9,099

1111111
10000011111111111
11000N01000000001
110000111011110011111
100000000000110000001
100000000001 1000000011
100000000000110000001
100001010000110000001
100001010000000000001
111111111111111111111
